----------------------------------------------unit8 pa
telephoney电话
telegraph电报
step-by-step步进
two-motion两运动
progressive electromachanical steps												渐进式电动机械步骤
crossbar横梁
introduced介绍
marker标记
ledLED
deployment部署
high-capacity大容量
radio-relay无线电中继
quadrature amplitude modulation正交幅度调制
milestones里程碑
spur骨刺
repeater station中继站
stored-program control存储程序控制
pulse code modulation脉码调制
hierarchy等级制度
backbone骨干
propose提出
capable of relaying能够转播
characterized特征
packet switching分组交换
sponsorship赞助
International Telegraph and Telephone Consultative Committee国际电报电话咨询委员会
adoption采用
Internation Organization of Standardization国际标准化组织
Open-System-Interconnections开放系统互连
reference mode参考模式
as long as只要
obey遵守
ampification放大
ingredient	成分
integrated services digital networks												综合业务数字网络
the Federal Communications Commission										联邦通信委员会
cellular				细胞的
crossbar纵横式
electric switch电子交换机

----------------------------------------------unit8 pa
----------------------------------------------unit8 pb
telecomunication		电信
transmission			传输
form of electronic		电子形式
electromagnetic signals		电磁信号
data communication network	数据通信网络
flow				流
consist of			包括
transaction			交易
mailing address			邮寄地址
mailing list			邮件列表
leased				租用
transmitter			发射机
cable interface			有线接口
modem				调制解调器
modulator			调制器
demodulator			解调器
clustered			集群
parallel			平行
indicates			指示
integral element		整体元素
various				各个
file-transfer			文件传输
host-terminal			主机终端
agents				代理
dumb				哑
varying				不同
capabilities			功能
strictly			严格
diskette			软盘
outgrowth			生长
memorandum			备忘录
interconnected			互联
private branch exchange		专用小交换机网
in close proximity		在附近
relatively recent development	相对较新的发展
information retrievel		信息检索
bulletin-board			布告栏
invest				投资
quotation			行情
corporate-earning		企业 - 盈利
estimates			估计
disclosures			披露
survey				调查
dialog				对话
telexes				电报
postal				邮政
certain telecommunication methods某些电信方式
dominate			支配
varity				品种
integrated services digital network综合服务数字网络
peripheral			外围设备
biliographic			书目
facilitate			促进
in the form of			以...的形式
take the form of		采取的形式
as such				因此
as a whole			作为一个整体
in this respect			在这方面
ANSI  American National Standards Institude美国国家标准局
CCITT  International Telegraph and Telephone Consultative Committee国际电报电话咨询委员会
IEE  Institute of Electrical Engineers电气工程师学会
EIA  Electronic Industries Association电子工业协会
---------------------------------------------------------------------unit8 pb
---------------------------------------------------------------------unit9 pa
numerical			数值的,数字的
digitization			数字化
simultaneously			同时地
emulation			仿真
simulation			模拟
reconfigurable			可重新配置的
appliance			用具, 器具
compatible			兼容性
concepts			概念
representation			表示
essential			必要
sample and hold circuit		采样保持电路
interval			间隔
reciprocal			倒数
aliasing			混叠现象
distortion			失真
precede				领先的,在...之前, 先于
brief acquisition time		短暂的采集时间
corresponds			对应
quantization			量化
full scale range		满量程范围
signal-to-noise ratio		信噪比
zero-order hold			零阶保持
time to market			上市时间
vertical lines			垂直线
assigned			分配
summarize			总结
proportional			成比例的
steady				稳定
staircase-like			阶梯状
erroneously			误
baseband			基带
exploited			利用
narrow				狭窄
deduce				推断
spectrum			频谱,光谱
spectral			...的频谱
typically			一般
implement			实行
trick				窍门, 诡计, 诀窍
delivers			提供
power consumption		能量消耗
incredibly			令人难以置信
single-cycle			单周期
accumulate			积累
infrastructure			基础设施
in conjunction with		与...协力
under sampling			欠采样
spectrum inversion		频谱翻转
more often than not		时常
bus interface			总线接口

iteratively			迭代
foundry				铸造厂, 半导体制造商
proposition			主张
impediment			障碍
availing			援用
glue logic			互联逻辑
functional accelerator		性能加速器
contrast			对比
optimized			优化
dinosaurs			恐龙
encumbered			拖累
embraces			拥抱
hand-held			手持式
bound				界
hold time			保持时间
--------------------------------------------------unit9 pa
--------------------------------------------------unit10 pa
extraterrestrial		外星人
wreak				发泄
beam				光束
inevitable			必然
chillingly			冷竣
premonition			征兆
infrared			红外线
leaped				飞跃
destructive			有害
substitude			分别代替
machinery			机械
techno-spy			TECHNO-间谍
thriller			惊悚,恐怖
tied down			束缚
villain				恶棍
spread				传播
genitals			生殖器
swath				大片
asunder				四分五裂
length-wise			长度方向
alas				唉
indeed				确实
faint				晕
pencil lines			铅笔线
scattered			疏散
projecting			突出
sheet of steel			钢板
detect				检测
dramatic			戏剧性
igniting			点火
thermonuclear fusion reaction	热核聚变反应
seemingly mundane 		看似平凡
intense				激烈
contradiction			矛盾
intensity			强度
reflection			反射
bounced off			反弹
---------------------------------------------------------unit10 pa
---------------------------------------------------------unit11 pa
information accumulated		信息积累
specific portion		特定部分
organize			组织
characters			人物
fields				领域
multiple related files		多个相关文件
by contrast			相比之下
report				报告
payroll				工资表
inventory			库存
ledger				总帐
redundantly			冗余
subtle				微妙
retrieving			检索
consequently			所以
responsibility			责任
rests				休息
redundant			冗
duplicate			重复

---------------------------------------------------------unit11 pa
---------------------------------------------------------unit11


















	



























